1111111111111
100000000C111
1P0000000E1
1111111111111