11111111111111
10000000000000
11111111111111
1P000C0000E000
11111111111111